111111111111111111111111111111111111111111111111111111111111
1                                                          1
1                                                          1
1                                                          1
1   1111   11   11    11   11    111     111   11   111    1
1   1111   11   11    11   11    111     111   11   111    1
1   1111   11   11    11   11    111     111   11   111    1
1   1111   11   11    11   11    111     111   11   111    1
1   1111   11   11    11   11    111     111   11   111    1
1   1111   11   11    11   11    111     111   11   111    1
1   1111   11   11    11   11    111     111   11   111    1
1   1111   11   11    11   11    111     111   11   111    1
1   1111   11   11    11   11    111     111   11   111    1
1   1111   11   11    11   11    111     111   11   111    1
1   1111   11   11    11   11    111     111   11   111    1
1   1111   11   11    11   11    111     111   11   111    1
1   1111   11   11    11   11    111     111   11   111    1
1   1111   11   11    11   11    111     111   11   111    1
1   1111   11   11    11   11    111     111   11   111    1
1   1111   11   11    11   11    111     111   11   111    1
1                                                          1
1                                                          1
1                                                          1
1                                                          1
1       111111111111111111111111111111111111111            1
1       111111111111111111111111111111111111111            1
1       111111111111111111111111111111111111111            1
1                                                          1
1                                                          1
1                                                          1
1                                                          1
1   1111   11   11    11   11    111     111   11   111    1
1   1111   11   11    11   11    111     111   11   111    1
1   1111   11   11    11   11    111     111   11   111    1
1   1111   11   11    11   11    111     111   11   111    1
1   1111   11   11    11   11    111     111   11   111    1
1   1111   11   11    11   11    111     111   11   111    1
1   1111   11   11    11   11    111     111   11   111    1
1   1111   11   11    11   11    111     111   11   111    1
1   1111   11   11    11   11    111     111   11   111    1
1   1111   11   11    11   11    111     111   11   111    1
1   1111   11   11    11   11    111     111   11   111    1
1   1111   11   11    11   11    111     111   11   111    1
1   1111   11   11    11   11    111     111   11   111    1
1   1111   11   11    11   11    111     111   11   111    1
1   1111   11   11    11   11    111     111   11   111    1
1   1111   11   11    11   11    111     111   11   111    1
1                                                          1
1                                                          1
1                                                          1
1         11111                              11111         1
1         11111                              11111         1
1         11111           11111111           11111         1
1                         1      1                         1
1                         1      1                         1
1                         1      1                         1
111111111111111111111111111111111111111111111111111111111111

